     11111111111
     10000000001
     11001000001
1111110001000001
1110000000000001
11100000S0000001
1100001000000001
1100001000011001
1111111110011001
1111111100000001
1110000000000001
1000000000000001
1111000011111111
1100000000000001
1110011111111111
1111111111111111