     11111111111
     10000000001
     11000000001
1111110000000001
1110000000000001
1110200111110001
110012000N000021
1100000002200001
1100000001000001
1100000000000001
1110000000000001
1000000000000001
1111000000000001
1100000000000001
1110011111111111
1111111111111111