R 512 512
NO /Users/cerebus/projects/clion_cub3d2/textures/128caves_wall.xpm
SO /Users/cerebus/projects/clion_cub3d2/textures/128gate.xpm
WE /Users/cerebus/projects/clion_cub3d2/textures/128hell_nasty03.xpm
EA /Users/cerebus/projects/clion_cub3d2/textures/128mcity_wall11.xpm
S /Users/cerebus/projects/clion_cub3d2/sprites/barrel.xpm

F 132  ,132, 130
C 160,160,160

111111111111111111111111111111
    1100000000110000000000011111110
    11111100100111000000200000001
    10010000000000000000000011111
111111111011000011100000000000011111111
1000000000011000011101110001111111
1110110110000011100000010101111111111111
11110111111111011101N2001000111
110000001101010111000000100011
10002000000000011100000210001111
1000000000000011 1110100100011
1100000101010001  11101111000111
1111011101110101   1111110100011
1111111111111111     111111111111
111111111111111     111111111111