R 512 512

NO /Users/anastasia/CLionProjects/clion_cub3d2/textures/128caves_wall.xpm
SO /Users/anastasia/CLionProjects/clion_cub3d2/textures/128gate.xpm
WE /Users/anastasia/CLionProjects/clion_cub3d2/textures/128mcity_wall11.xpm
EA /Users/anastasia/CLionProjects/clion_cub3d2/textures/128hell_nasty03.xpm
S  /Users/anastasia/CLionProjects/clion_cub3d2/sprites/pillar.xpm

F 132,132 , 130
C 160,160,160

     1111
     10011111111
     11000000001
1111110000000001
1110000000000001
1110200111110001
1100100000002021
1100000002200001
1100000001000001
11001N2000000001
1110020000002001
1200000000000001
1111000000000001
1120011111111111
111001
  1111111