R 512 512

NO /Users/cerebus/projects/clion_cub3d2/textures/128caves_wall.xpm
SO /Users/cerebus/projects/clion_cub3d2/textures/128gate.xpm
WE /Users/cerebus/projects/clion_cub3d2/textures/128hell_nasty03.xpm
EA /Users/cerebus/projects/clion_cub3d2/textures/128mcity_wall11.xpm
S /Users/cerebus/projects/clion_cub3d2/sprites/barrel.xpm

F         132,132,132
C        160,160,160

11111111111111111111111111111
   110000000011000000000001111111
   110111110100211000E00200000001
   1110010002000000020000020011111
111111111011000011100020000000011111
1000000000011000011101110001111111
1110110110000011100000010101111111111111
1111011111111101110102001000111
110000001101010111000000100011
10002000000000011100000210001111
1000000000000011111101001000111
1100000101010001 1111101111000111
1111011101110101  1111110100011111
1111111111111111    11111111111