R 1920 1080
NO /Users/cerebus/projects/clion_cub3d2/textures/128caves_wall.xpm
SO /Users/cerebus/projects/clion_cub3d2/textures/128gate.xpm
WE /Users/cerebus/projects/clion_cub3d2/textures/128hell_nasty03.xpm
EA /Users/cerebus/projects/clion_cub3d2/textures/128mcity_wall11.xpm
S /Users/cerebus/projects/clion_cub3d2/sprites/barrel.xpm
F 220,100,0
C 225,30,0

     11111111
     12000000111
     11000000001
1111110000000001
1110000000000001
1110200111110001
1100120000002001
1100000002200001
1100000001000001
1100002000000001
1110020000002001
1200000000000001
111100000E000001
1120000000000001
1110011111111111
1111111111111111