R 1920 1080
NO /Users/cerebus/projects/clion_cub3d2/textures/128caves_wall.xpm
SO /Users/cerebus/projects/clion_cub3d2/textures/128gate.xpm
WE /Users/cerebus/projects/clion_cub3d2/textures/128hell_nasty03.xpm
EA /Users/cerebus/projects/clion_cub3d2/textures/128mcity_wall11.xpm
S /Users/cerebus/projects/clion_cub3d2/sprites/barrel.xpm
F 220,100,0
C 225,30,0

    111111111111111111111111111111
    11000000001100000000000111111
    111111001001110000002000000011
    10010000000000000000000011111
111111111011000011100000000000011111111
100000000011000011101110001111111   1111
1110111111111011100000010101111111111111
1111011111111101110101001000111
11000000110101011100000010001
10002000000000001100000010001
10000000000000001101010010001
11000001010101011111011110N0111
1111011101110101 111110100011
1111111111111111 111111111111